WWWWWWWWWWWWWWWWWWWWW
WWWWWWWWWWWWWWWWWWWWS
WWWWWWWWWWWWWWWWWWWWS
SSSSSGGGGGGSSSSSSSSSS
SGGGGGGGGGGGGGGGGGGGS
SGGGGGGGGGGGGGGGGGGGS
SSNNSSSSSSSSSSSSSSSSS