WWWWWWWWWWWWWWWWWWWWWWWWWWWWWW
WWWWWWWWWWWWWWWWWWWWSWWWWWWWWW
SGGGGGGGGGGGGGGGGGGGSGGGGGGGGG
SGGGGGGGGGGGGGGGGGGGSGGGGGGGGG
SSGSSSSSSSSSSSSSSSSSSGGGGGGGGG
SWWWWWWWWWWWWWWWWWWWWWWWWWWWWS
SWWWWWWWWWWWWWWWWWWWWWWWWWWWWS