WWWSSSSSSSSSSSSSSSSSS
SWWWWWWWWWWWWWWWWWWWS
SWWWWWWWWWWWWWWWWWWWS
SSSSSSSSSGGSSSSSSSSSS
SGGGGGGGGGGGGGGGGGGGS
SGGGGGGGGGGGGGGGGGGGS
SSNNSSSSSSSSSSSSSSSSS