SSSSSSSSSSSSSSSSSSSSS
SWWWWWWWWWWWWWWWWWWWS
SWWWWWWWWWWWWWWWWWWWS
SSSSSSSSSSSSSSSSSSSSS
SGGGGGGGGGGGGGGGGGGGS
SGGGGGGGGGGGGGGGGGGGS
SSNNSSSSSSSSSSSSSSSSS